EDEEEEEEE
EWWWWWWEW
EWEEEEEEE
EWWWWEWWW
EWEEEEWEE
EWEEWWWEE
EWEEWEWEA
EWEWWEWEE
EWEEWEEEE
EEWEEEEEE
EEWWWEEEW
WWEWEWWWE